50 15
1 1 1 1 1 1 1 1 1 1 1 1 1 1 1 1 1 1 1 1 1 1 1 1 1 1 1 1 1 1 1 1 1 1 1 1 1 1 1 1 1 1 1 1 1 1 1 1 1 1
1 1 1 1 1 1 3 1 1 1 1 1 1 1 1 1 1 1 1 1 1 1 1 1 1 1 1 1 1 1 1 1 1 1 1 1 1 1 1 1 1 1 1 1 1 1 1 1 1 16
1 1 1 1 1 1 1 1 1 1 1 1 1 1 1 1 1 1 1 1 9 1 1 1 1 1 1 1 1 1 1 1 1 9 1 1 1 1 1 1 1 1 1 1 1 1 1 1 16 16
1 1 1 1 1 1 1 1 1 1 1 1 1 1 1 14 14 14 14 14 0 0 0 0 1 1 0 0 1 10 0 0 0 0 1 1 1 1 1 10 1 1 1 1 0 0 0 0 2 16
1 1 1 1 1 1 1 1 1 1 1 1 1 1 1 15 2 15 15 15 2 2 2 2 0 0 2 2 0 0 2 2 2 2 0 1 1 1 0 0 0 0 0 0 0 2 2 2 16 1
1 1 1 1 1 1 1 1 1 1 1 1 1 1 1 15 16 2 15 2 2 2 2 2 2 2 16 16 2 2 16 1 1 16 2 16 1 16 2 2 16 16 16 2 2 16 16 16 1 1
1 1 1 1 1 1 1 8 8 8 1 1 1 1 1 15 1 16 16 16 16 2 2 2 16 16 1 1 16 16 1 1 16 16 16 1 1 1 16 16 16 16 16 16 16 1 1 1 1 1
1 1 1 1 1 1 8 8 8 8 8 1 1 1 1 15 1 1 1 1 16 16 16 16 1 1 1 1 1 1 1 1 1 1 1 1 1 1 1 1 1 1 1 1 1 1 1 1 1 1
1 1 1 1 1 1 1 1 12 1 1 1 1 1 1 15 1 1 1 16 16 16 16 1 1 1 13 1 1 1 1 1 1 1 1 1 1 1 1 1 1 1 1 1 1 1 1 1 1 1
1 1 1 1 1 5 11 11 7 1 1 1 1 1 1 15 1 1 1 16 16 16 16 16 5 11 7 1 0 16 16 16 16 16 16 16 16 1 1 1 1 1 1 1 1 9 1 1 1 9
1 1 1 1 1 1 1 1 7 10 1 1 1 1 16 15 14 14 16 16 16 16 16 16 1 0 7 0 2 16 1 1 16 16 16 1 1 1 1 0 0 0 0 0 0 0 0 0 0 0
1 1 1 1 1 1 1 0 0 0 1 1 1 16 16 16 15 16 1 1 16 16 16 1 1 16 2 16 16 16 1 16 16 1 1 1 1 1 16 2 2 2 2 2 2 2 2 2 2 2
1 1 1 1 1 1 0 2 2 2 0 1 1 1 1 1 16 16 1 16 16 16 16 1 16 16 16 16 1 1 1 1 1 1 1 1 1 1 16 16 2 2 2 2 2 2 2 2 2 2
1 16 16 16 1 1 2 2 2 2 2 0 1 1 1 1 1 1 1 1 1 1 1 1 1 1 1 1 1 1 1 1 1 1 1 1 16 16 16 16 16 16 2 2 2 2 2 2 2 2
16 16 16 16 1 1 16 16 16 16 16 16 16 16 16 16 16 16 16 16 16 16 16 16 16 16 16 16 16 16 16 16 16 16 16 16 16 16 16 16 16 16 16 16 16 16 16 16 16 2