34 14
1 1 1 1 1 1 1 1 1 1 1 1 1 1 1 1 1 1 1 1 1 1 1 1 1 1 1 1 1 1 1 1 1 1
1 1 1 1 1 1 1 1 1 1 1 1 1 1 1 1 1 1 1 1 1 1 1 1 1 1 1 1 1 1 1 1 1 1
1 1 1 1 1 1 1 1 1 1 1 1 1 1 1 1 1 1 1 1 1 1 1 1 1 1 1 1 1 1 1 1 1 1
1 3 1 1 1 1 1 1 1 1 1 1 1 1 1 1 1 1 1 1 1 1 1 1 1 1 1 1 1 1 1 1 1 1
1 1 1 1 1 1 1 1 1 1 1 1 1 1 1 1 1 8 8 8 1 1 1 1 1 1 1 1 1 1 1 1 1 1
1 1 1 1 1 1 1 8 8 8 1 1 1 1 1 1 8 8 8 8 8 1 1 1 1 1 1 1 1 1 1 1 1 1
1 1 1 1 1 1 1 8 8 8 1 1 1 1 1 1 8 8 8 8 8 1 1 1 1 1 1 1 8 8 8 1 1 1
1 1 1 1 1 1 1 1 7 11 6 1 1 1 1 1 1 1 12 1 1 1 1 1 1 1 1 1 8 8 8 1 1 1
1 1 1 1 1 1 5 11 7 1 1 1 1 1 1 5 11 11 13 1 1 1 1 1 1 1 1 1 1 7 1 1 1 1
1 1 1 1 1 1 1 1 7 1 9 1 1 1 1 1 1 1 7 1 1 1 1 1 1 1 1 1 1 7 1 9 1 1
1 1 1 1 1 0 0 0 0 0 0 1 1 1 1 1 1 1 7 1 10 1 1 1 1 1 1 0 0 0 0 0 0 0
1 1 10 1 0 0 0 0 0 0 0 0 14 14 14 14 0 0 0 0 0 0 1 1 1 1 0 0 0 0 0 0 0 0
0 0 0 0 0 0 0 0 0 0 0 0 15 15 15 15 0 0 0 0 0 0 0 0 0 0 0 0 0 0 0 0 0 0
2 2 2 2 2 2 2 2 2 2 2 2 15 15 15 15 2 2 2 2 2 2 2 2 2 2 2 2 2 2 2 2 2 2